11111111111111111
10000000220022201
10101210101210101
12000222000020021
10101010101212121
10202000020000021
10101010101210101
12000202220002221
12101010101012121
12200202020002001
10101010101210101
10220002000200031
11111111111111111
